F 220,100,0
C 225,30,0
NO ./texure/xpm/wood.xpm
SO ./texure/xpm/wood.xpm
WE ./texure/xpm/wood.xpm
EA ./texure/xpm/wood.xpm

1111111111111
1000000000E01
1000000000001
1000000000001
1111111111111
