11111111111111111111111111111111111
10000000000000000000000000000000001
10000000000000000000000000000000001
10000000000000000000000000000000001
10000000100000000000000000000000001
11100000000000000000000000000000001
10000000000000110000000000000000001
11111111111111111111111111111111111
