1111111111111111111111111111111111111111111111111111111111111111111111
1011111111111111111111111111111101110000000011111111111100000000000001
1000001111111111111111111111111111110000000011111111111100000000000001
1000000001111111111110000000000000110000000011111111111100000000000001
1000000010000000000000000000000000110000000011111111111100000000000001
1110000000000000000000000000000000110000000011111111111100000000000001
1000000000000011000000000000000000110000000011111111111100000000000001
1111111111111111111111111111111111110000000011111111111100000000000001
1011111111111111111111111111111101110000000011111111111100000000000001
1000001111111111111111111111111111110000000011111111111100000000000001
1000000001111111111110000000000000110000000011111111111100000000000001
1000000010000000000000000000000000110000000011111111111100000000000001
1110000000000000000000000000000000110000000011111111111100000000000001
1000000000000011000000000000000000110000000011111111111100000000000001
1111111111111111111111111111111111110000000011111111111100000000000001
1111111111111111111111111111111111110000000011111111111100000000000001
1011111111111111111111111111111101110000000011111111111100000000000001
1000001111111111111111111111111111110000000011111111111100000000000001
1000000001111111111110000000000000110000000011111111111100000000000001
1000000010000000000000000000000000110000000011111111111100000000000001
1110000000000000000000000000000000110000000011111111111100000000000001
1000000000000011000000000000000000110000000011111111111100000000000001
1111111111111111111111111111111111110000000011111111111100000000000001
1111111111111111111111111111111111110000000011111111111100000000000001
1011111111111111111111111111111101110000000011111111111100000000000001
1000001111111111111111111111111111110000000011111111111100000000000001
1000000001111111111110000000000000110000000011111111111100000000000001
1000000010000000000000000000000000110000000011111111111100000000000001
1110000000000000000000000000000000110000000011111111111100000000000001
1000000000000011000000000000000000110000000011111111111100000000000001
1111111111111111111111111111111111111111111111111111111111111111111111
